+ + + + + + +
+ - * - - - +
+ - - - $ - +
+ X - - @ - +
+ - - - - - +
+ $ - + - - +
+ + - - - - +
+ X @ - $ - +
+ + - - - - +
+ + + + + + +
