- + + + + + + - - -
- + X - - X + - - -
+ + - @ @ + + - - -
+ - - - - + + - - -
+ - @ - - * + + + +
+ + - - - - - - X +
- + + + + + + + + +
