- + + + + + + - -
+ + X - @ - + + +
+ - - - - - - - +
+ - @ + + X - @ +
+ - - - @ - + - +
+ + + * - X - X +
- - + + + + + + +
