- + + + + + + + -
+ + - - + - - + +
+ - @ - - - @ - +
+ - - X * X - - +
+ + @ + + - - + +
+ - - X - - - + -
+ + + + + + + + -
